-------------------------
-           -           -
-           -           -
-    ===r               -
-                       -
-           -           -
-           -           -
-           -           -
-                       -
-                       -
-           -           -
-------------------------